8 7
WWWWWWWW
W00000WW
WWW0W0WW
W0W0WGWW
WaW0WWWW
WS0A00WW
WWWWWWWW