10 10
G000D00000
0WWWWWWWW0
0Wd0000000
WWWWWWWWWC
c000000000
WWWWWWWWWB
00000000W0
bWWWW00000
W00aWWWWW0
S000000A00
